1 2 1 2 3 4 5 6 1 2 1 2 3 4 7 8 1 2 1 2 3 4 5 6 1 2 9 10 3 4 5 6 9 10 1 2 1 2 1 2 1 2 3 4 5 6 11 11 3 4 12 13 1 2 1 2 9 10 3 4 9 10 3 4 9 10 3 4 9 10 3 4 1 2 9 10 1 2 12 13 12 13 1 2 11 11 3 4 14 15 
16 17 18 19 3 4 20 21 16 17 18 19 3 4 7 22 16 17 18 19 3 4 20 21 16 17 23 24 3 4 20 21 11 11 18 19 18 19 18 19 18 19 3 4 25 26 11 11 3 4 18 19 18 19 18 19 23 24 3 4 11 11 3 4 11 11 3 4 11 11 3 4 18 19 11 11 18 19 18 19 18 19 18 19 11 11 3 4 27 28 
9 10 1 2 3 4 29 30 9 10 1 2 3 4 5 6 9 10 1 2 3 4 29 30 9 10 12 13 3 4 29 30 11 11 1 2 1 2 1 2 1 2 3 4 31 32 11 11 3 4 1 2 1 2 1 2 12 13 3 4 11 11 3 4 11 11 3 4 11 11 3 4 1 2 11 11 1 2 1 2 1 2 1 2 11 11 3 4 27 33 
11 11 18 19 3 4 20 21 11 11 18 19 3 4 20 21 11 11 18 19 3 4 20 21 11 11 18 19 3 4 20 21 11 11 18 19 18 19 34 35 36 37 38 39 40 41 42 42 42 42 43 44 45 46 18 19 18 19 3 4 11 11 3 4 11 11 3 4 11 11 3 4 16 17 11 11 18 19 34 35 36 37 42 42 40 41 38 39 27 47 
11 11 1 2 3 4 29 30 11 11 1 2 3 4 29 30 11 11 1 2 3 4 29 30 11 11 1 2 3 4 29 30 11 11 1 2 1 2 48 36 49 50 50 50 50 50 50 50 50 50 50 51 52 53 1 2 1 2 3 4 11 11 3 4 11 11 3 4 11 11 3 4 9 10 11 11 1 2 48 36 49 50 50 50 50 50 50 50 50 50 
11 11 18 19 3 4 25 26 11 11 16 17 3 4 20 21 11 11 18 19 3 4 25 26 11 11 18 19 3 4 20 21 11 11 34 35 36 37 54 49 55 56 3 4 18 19 23 24 3 4 57 58 51 59 40 41 42 42 3 4 11 11 3 4 11 11 3 4 11 11 3 4 23 24 11 11 34 35 60 49 55 56 18 19 18 19 61 62 63 15 
11 11 1 2 3 4 31 32 11 11 9 10 3 4 29 30 11 11 1 2 3 4 31 32 11 11 1 2 3 4 29 30 11 11 48 36 49 50 50 50 64 65 3 4 1 2 12 13 3 4 66 67 50 50 50 50 50 50 3 4 11 11 3 4 11 11 3 4 11 11 3 4 12 13 11 11 48 36 49 68 64 65 1 2 1 2 3 4 14 15 
11 11 16 17 3 4 18 19 11 11 23 24 3 4 25 26 11 11 18 19 3 4 18 19 11 11 23 24 3 4 25 26 34 35 60 49 55 56 16 17 18 19 3 4 18 19 18 19 3 4 18 19 3 4 16 17 16 17 3 4 11 11 3 4 11 11 3 4 11 11 3 4 16 17 34 35 60 49 55 56 16 17 18 19 18 19 3 4 63 15 
11 11 9 10 3 4 1 2 11 11 12 13 3 4 31 32 11 11 1 2 3 4 1 2 11 11 12 13 3 4 31 32 48 36 49 68 64 65 9 10 1 2 3 4 1 2 1 2 3 4 1 2 3 4 9 10 9 10 3 4 11 11 3 4 11 11 3 4 11 11 3 4 9 10 48 36 49 68 64 65 9 10 1 2 1 2 3 4 14 15 
40 41 40 41 38 39 40 41 40 41 40 41 38 39 40 41 40 41 40 41 38 39 40 41 40 41 40 41 38 39 40 41 54 49 40 41 40 41 40 41 40 41 38 39 40 41 40 41 38 39 40 41 38 39 40 41 40 41 38 39 40 41 38 39 40 41 38 39 40 41 38 39 40 41 54 49 40 41 40 41 40 41 40 41 40 41 38 39 69 15 
50 50 50 50 50 50 50 50 50 50 50 50 50 50 50 50 50 50 50 50 50 50 50 50 50 50 50 50 50 50 50 50 50 50 50 50 50 50 50 50 50 50 50 50 50 50 50 50 50 50 50 50 50 50 50 50 50 50 50 50 50 50 50 50 50 50 50 50 50 50 50 50 50 50 50 50 50 50 50 50 50 50 50 50 50 50 50 50 50 50 
